Зорсаны -- The Zorsan (всегда с артиклем, без -s в конце)
Зорсан -- Zorsan
Клиски -- Klisks
Клискада -- Kliskada
Бродяги -- Rogues
Борки -- Borks
Шипшиар, Сипсия -- Sypsyar
Садовники -- Gardeners
Генри Лишкевич -- Henry Liszkiewicz
Мэганн Лишкевич, Бак Лишкевич, Лиза Фоллс, Ричард Фоллс -- Megan Liszkiewicz, Buck Liszkiewicz, Liza Falls, Richard Falls
Сара Фронтц -- Sarah Frontz
Мордехай Фронтц, Суламифь Фронтц -- Mordechai Frontz, Sulamith Frontz
Гордон -- Gordon
Кодекс Обмена -- Code of Commerce
Философия Пути -- Philosophy of the Path
Аврора 1/2 -- The Aurora 1/2 (с артиклем)
Хрррака -- Hrrraka
Картар -- Kartar
Старейшина Хур -- Elder Hoor
Мазершип Брау -- Mothership Brau
Эролоа -- Eroloa
Суть Пожирателя -- The Essence of the Devourer
Мартан Килмови -- Martan Kilmovee
Хаказар -- Hakazar
Американский Альянс -- American Alliance
Азиатский Союз -- Asian Union
Европейское Объединение -- European Alliance
Совет Ветеранов -- Veteran Council
Торнур -- Tornur
Длороу -- Dlorou
Vortangu. Hakazar. Falronek. Porakef. Trokanfe.(Klisk corps)
Конгломерат корпораций -- The Conglomerate of Corporations
Фурнут -- Foornoot
Ка -- Ka
Хумбата -- Hoombata
Хоршак -- Horshak
Хурката Фамрана -- Hoorkata Famrana
Жэурдэ -- Zheurde
Нтанда -- Ntanda
Урилэй -- Urilay
Грорра -- Grorra
Фирше -- Firshe
Фшиир -- Fshiir